1111111111
6000010001
1101000101
1001111111
1010110001
1000110101
1101110111
1101100001
1000001109
1111111111